========================
=       =              =
=  ======              =
====    =              =
=  =  o =              =
=* =    =     O        =
=  =####=              =
=##=    =              =
=  =    =              =
=  #    #              =
=  #    #              =
========================